X,X,X,X,X,X,X,X,X
X,D,D,D,D,D,D,D,X
X,D,0,0,0,0,0,0,X
X,0,0,0,0,0,0,0,X
X,0,0,0,0,0,0,0,X
X,0,0,0,0,0,0,0,X
X,0,0,0,0,0,0,0,X
X,0,0,0,0,0,0,0,X
X,0,0,0,0,0,0,0,X
X,D,0,0,0,0,0,0,X
X,D,0,0,0,0,0,0,X
X,D,0,0,0,0,0,D,X
X,D,D,D,D,D,D,D,X
